[ 
    "оллол",
    "лолло",
    "олоол",
    "ллоло",
    "оолол",
    "ололл",
    "лолоо",
    "ололо",
    "ллоло"
]