[
    "влаво",
    "овала",
    "ловла",
    "аловл",
    "алвло",
    "алаво",
    "ловла", 
    "валао",
    "лалво",
    "аолов"
]