[
    "джждж",
    "жджжд",
    "джддж",
    "жжджд",
    "ддждж",
    "джджж",
    "ждждд",
    "джджд",
    "жжджд"
]