[
    "фыыфы",
    "ыфыыф", 
    "фыффы", 
    "ыыфыф", 
    "ффыфы", 
    "фыфыы", 
    "ыфыфф"
]