[
	"нггнг",
	"гнггн",
	"нгннг",
	"ггнгн",
	"ннгнг",
	"нгнгг",
	"гнгнн",
	"нгнгн",
	"ггнгн",
	"ннгнг"
]
