[
	"кееке",
	"екеек",
	"кекке",
	"еекек",
	"ккеке",
	"кекее",
	"екекк",
	"кекек",
	"еекек",
	"ккеке"
]
