[
	"тььть",
	"ьтььт",
	"тьтть",
	"ььтьт",
	"ттьть",
	"тьтьь",
	"ьтьтт",
	"тьтьт",
	"ььтьт",
	"ттьть"
]
