[
	"миими",
	"имиим",
	"мимми",
	"иимим",
	"ммими",
	"мимии",
	"имимм",
	"мимим",
	"иимим"
]
