[
	"шщщшщ",
	"щшщщш",
	"шщшшщ",
	"щщшщш",
	"шшщшщ",
	"шщшщщ",
	"щшщшш"
]
