[
	"бююбю",
	"юбююб",
	"бюббю",
	"ююбюб",
	"ббюбю",
	"бюбюю",
	"юбюбб",
	"бюбюб"
]
