[
	"цууцу",
	"уцууц",
	"цуццу",
	"ууцуц",
	"ццуцу",
	"цуцуу",
	"уцуцц",
	"цуцуц",
	"ууцуц",
	"ццуцу"
]
