[
	"чссчс",
	"счссч",
	"чсччс",
	"ссчсч",
	"ччсчс",
	"чсчсс",
	"счсчч",
	"чсчсч",
	"ссчсч",
	"ччсчс"
]
