[
	"зххзх",
	"хзххз",
	"зхззх",
	"ххзхз",
	"ззхзх",
	"зхзхх",
	"хзхзз",
	"зхзхз",
	"ххзхз",
	"ззхзх"
]
