[
	"яййяй",
	"йяййя",
	"яйяяй",
	"ййяйя",
	"яяйяй",
	"яйяйй",
	"йяйяя",
	"яйяйя",
	"ййяйя",
	"яяйяй"
]
