[
	"90090",
	"09009",
	"90990",
	"00909",
	"99090",
	"90900",
	"09099",
	"90909",
	"00909",
	"99090"
]
