[
	"12212",
	"21221",
	"12112",
	"22121",
	"11212",
	"12122",
	"21211",
	"12121",
	"22121",
	"11212"
]
