[
	"56656",
	"65665",
	"56556",
	"66565",
	"55656",
	"56566",
	"65655",
	"56565",
	"66565",
	"55656"
]
