[
	"78878",
	"87887",
	"78778",
	"88787",
	"77878",
	"78788",
	"87877",
	"78787",
	"88787",
	"77878"
]
